|||||||||||||||||||||||||||||
|000000001000|||000100000000|
|0||||0|||||0|||0|||||0||||0|
|0||||0|||||0|||0|||||0||||0|
|0||||0|||||0|||0|||||0||||0|
|000000000000000000000000000|
|0||||0||0|||||||||0||0||||0|
|0||||0||0|||||||||0||0||||0|
|000000||0000|||0000||000000|
||||0|0|||||0|||0|||||0|0||||
|0000|0|||||0|||0|||||0|0000|
|1||||0||A_________B||0||||1|
|0000|0||_|_|||||||_||0|0000|
||||0|0||_|__|||____||0|0||||
-00000000_||_____||_00000000-
|0||||0||____|||__|_||0||||0|
|0000|0||_|||||||_|_||0|0000|
||||1|0||C_________D||0|1||||
|0000|0||0|||||||||0||0|0000|
|0||||0||0|||||||||0||0||||0|
|000000000000|||000000000000|
|0||||0|||||0|||0|||||0||||0|
|0||||0|||||0|||0|||||0||||0|
|000||0000000p_P0000000||000|
|||0||0||0|||||||||0||0||0|||
|||0||0||0|||||||||0||0||0|||
|100000||0000|||0000||000001|
|0||||||||||0|||0||||||||||0|
|0||||||||||0|||0||||||||||0|
|000000000000000000000000000|
|||||||||||||||||||||||||||||
