||||||||||||||||||||||||||||
|000000000000||000000000000|
|0||||0|||||0||0|||||0||||0|
|1||||0|||||0||0|||||0||||1|
|0||||0|||||0||0|||||0||||0|
|00000000000000000000000000|
|0||||0||0||||||||0||0||||0|
|0||||0||0||||||||0||0||||0|
|000000||0000||0000||000000|
||||||0|||||_||_|||||0||||||
||||||0|||||_||_|||||0||||||
||||||0||A________B||0||||||
||||||0||_|_||||||_||0||||||
||||||0||_|___|____||0||||||
______0___||____||___0______
||||||0||____|___|_||0||||||
||||||0||_||||||_|_||0||||||
||||||0||C________D||0||||||
||||||0||_||||||||_||0||||||
||||||0||_||||||||_||0||||||
|000000000000||000000000000|
|0||||0|||||0||0|||||0||||0|
|0||||0|||||0||0|||||0||||0|
|100||0000000pP0000000||001|
|||0||0||0||||||||0||0||0|||
|||0||0||0||||||||0||0||0|||
|000000||0000||0000||000000|
|0||||||||||0||0||||||||||0|
|0||||||||||0||0||||||||||0|
|00000000000000000000000000|
||||||||||||||||||||||||||||
